111111111111111111
1C0P01000100011001
100001000100000001
1C0100CCC0000000C1
1001010C0000000001
100001000000C00001
10010100000E00X001
1CC001001101101001
111111111111111111
