11111111111111111111111111
10C00100010C0110X000000001
1010P1C1010X01C0001110C0X1
10X11011X0001110000011X001
10X1000001X00C000X001E00X1
10000100X00001001000111111
11X01100C10001001X00110C11
1000C100110111100010X00001
11111111111111111111111111
