111111111111111111
100P0100010X011001
100001000100000001
10X1000000000C0001
100101000E00000001
10000100X000000001
10010100CC00000001
100001001101101001
111111111111111111
