11111111111111111111111111111111111111111
100P0100010001100000000000000000100000001
10000100010000000000000111111000100000001
100100C00000000CC000000000000000111000001
10010100000000000000000100000000000000001
10000100000000000000000100000000000000001
10010100000000000000000100000C00000000E01
10010100000000100000000100000000000000001
1000010011C110100001000100001000000CC1001
11111111111111111111111111111111111111111
