111111111111111111111
1C000X00000001X00C1C1
101110001110000001001
10100001E1P111X001X01
100X0000010001C100001
1000C0000100000000001
111111111111111111111