111111111111111111111
1C000000000001000C1C1
101110001110000001001
10100001E1P1110001001
10000000010001C100001
1000C0000100000000001
111111111111111111111