111111111111111111111
1C00000000000100000C1
111001C11111C10000111
10000111111C1100101E1
10C000000010000110101
100001000000001000001
1C1100001101001111111
111111111100000100001
1C0000000000010C010P1
111111111111111111111