111111111111111111111
1C00X0000000010X000C1
111001C11111C1000X111
1000X111111C1100101E1
10C0X00X00100X0110101
1000X1000000001X00001
1C11000X1101XX1111111
111111111100000100X01
1C0000X00000010C010P1
111111111111111111111