11111111111111111111111111
10C00100010C01100000000001
1010P1C1010001C0001110C001
10011011000011100000110001
1001000001000C0000001E0001
10000100000001001000111111
11001100C10001001000110C11
1000C100110111100010000001
11111111111111111111111111
