11111111111111111111111111
11P01C0X0C000X0000C01XC001
1X00100X000X0C0000X001E101
100X11X00C0X000X0C00X01001
1X001C10000000000000000X01
100X10111100X0011111111111
1X001XCXCXC10X100X0X000X01
100X110000010X0011C1C1C1C1
1C00X0001X0C10C010X00X00X1
11111111111111111111111111
