1111111111111
1P000CC000001
1000000000001
111111100C001
1000000000001
1000C11111111
1000000000E01
1111111111111