1111111111111
1P000CC000E01
1000000000001
1111111000001
1000000000001
1000011111111
1000000000001
1111111111111
